Player,Rk,Nation,Pos,Squad,Age,Born,90s,Tkl,TklW,Def 3rd,Mid 3rd,Att 3rd,Tkl_2,Att,Tkl%,Lost,Blocks,Sh,Pass,Int,Tkl+Int,Clr,Err,Matches
Aaron Cresswell,112,engENG,DF,West Ham,35-145,1989,7.5,9,5,4,4,1,7,9,77.8,2,9,4,5,8,17,34,0,Matches
Aaron Ramsdale,420,engENG,GK,Southampton,26-360,1998,27.0,0,0,0,0,0,0,2,0.0,2,0,0,0,2,2,8,2,Matches
Aaron Wan-Bissaka,537,engENG,DF,West Ham,27-164,1997,32.0,64,45,29,30,5,20,27,74.1,7,32,9,23,60,124,116,0,Matches
Abdoulaye Doucouré,146,mlMLI,MF,Everton,32-128,1993,26.9,45,27,20,18,7,13,39,33.3,26,30,6,24,9,54,19,1,Matches
Abdukodir Khusanov,280,uzUZB,DF,Manchester City,21-069,2004,5.6,5,4,4,1,0,2,3,66.7,1,5,4,1,3,8,29,1,Matches
Abdul Fatawu Issahaku,175,ghGHA,FW,Leicester City,21-062,2004,6.4,21,15,13,2,6,11,19,57.9,8,7,0,7,4,25,12,0,Matches
Adam Armstrong,33,engENG,"FW,MF",Southampton,28-088,1997,13.9,12,3,2,7,3,3,14,21.4,11,6,1,5,3,15,8,0,Matches
Adam Lallana,294,engENG,MF,Southampton,36-364,1988,4.0,8,5,4,4,0,2,12,16.7,10,4,1,3,5,13,5,0,Matches
Adam Smith,473,engENG,DF,Bournemouth,34-010,1991,15.7,21,10,10,5,6,12,25,48.0,13,12,5,7,14,35,47,1,Matches
Adam Webster,543,engENG,DF,Brighton,30-125,1995,6.9,8,5,4,3,1,5,11,45.5,6,12,9,3,14,22,28,1,Matches
Adam Wharton,547,engENG,MF,Crystal Palace,20-341,2004,14.6,34,14,14,16,4,17,44,38.6,27,11,2,9,20,54,27,0,Matches
Adama Traoré,513,esESP,"FW,MF",Fulham,29-104,1996,17.7,17,12,8,4,5,5,13,38.5,8,7,0,7,1,18,6,3,Matches
Albert Grønbaek,214,dkDEN,"FW,MF",Southampton,23-351,2001,1.6,4,1,1,1,2,3,10,30.0,7,1,1,0,0,4,1,0,Matches
Alejandro Garnacho,194,arARG,"MF,FW",Manchester Utd,20-312,2004,23.8,29,18,10,6,13,12,36,33.3,24,19,0,19,13,42,11,2,Matches
Alex Iwobi,251,ngNGA,"FW,MF",Fulham,29-006,1996,31.1,39,23,13,19,7,19,30,63.3,11,25,1,24,13,52,28,0,Matches
Alex McCarthy,338,engENG,GK,Southampton,35-157,1989,5.0,0,0,0,0,0,0,0,N/a,0,0,0,0,0,0,1,4,Matches
Alex Palmer,401,engENG,GK,Ipswich Town,28-272,1996,11.0,0,0,0,0,0,0,0,N/a,0,0,0,0,0,0,12,0,Matches
Alex Scott,458,engENG,MF,Bournemouth,21-261,2003,7.9,26,13,10,8,8,18,40,45.0,22,17,4,13,10,36,13,0,Matches
Alexander Isak,250,seSWE,FW,Newcastle Utd,25-230,1999,28.6,12,5,2,3,7,5,13,38.5,8,18,2,16,3,15,17,1,Matches
Alexis Mac Allister,314,arARG,MF,Liverpool,26-136,1998,28.6,95,58,28,51,16,55,104,52.9,49,61,6,55,22,117,29,1,Matches
Alfie Dorrington,145,engENG,DF,Tottenham,20-019,2005,0.2,0,0,0,0,0,0,0,N/a,0,0,0,0,0,0,0,0,Matches
Alfie Pond,415,engENG,DF,Wolves,21-069,2004,0.0,0,0,0,0,0,0,0,N/a,0,0,0,0,0,0,0,0,Matches
Ali Al Hamadi,225,iqIRQ,FW,Ipswich Town,23-069,2002,1.5,1,0,0,0,1,0,2,0.0,2,0,0,0,0,1,2,0,Matches
Alisson,16,brBRA,GK,Liverpool,32-219,1992,24.9,1,0,1,0,0,0,1,0.0,1,0,0,0,0,1,13,1,Matches
Alphonse Areola,31,frFRA,GK,West Ham,32-071,1993,23.1,2,2,2,0,0,2,3,66.7,1,0,0,0,0,2,15,2,Matches
Altay Bayındır,48,trTUR,GK,Manchester Utd,27-025,1998,2.0,0,0,0,0,0,0,1,0.0,1,0,0,0,0,0,5,1,Matches
Amad Diallo,131,ciCIV,"FW,MF",Manchester Utd,22-302,2002,18.2,35,28,7,19,9,17,28,60.7,11,11,0,11,11,46,16,0,Matches
Amadou Onana,392,beBEL,MF,Aston Villa,23-266,2001,15.3,47,24,21,22,4,14,26,53.8,12,14,6,8,24,71,37,3,Matches
Andreas Pereira,407,brBRA,MF,Fulham,29-128,1996,20.9,22,12,7,11,4,10,40,25.0,30,16,2,14,8,30,15,2,Matches
Andrew Robertson,433,sctSCO,DF,Liverpool,31-059,1994,25.6,38,22,24,10,4,30,47,63.8,17,9,4,5,20,58,51,2,Matches
André,26,brBRA,MF,Wolves,23-297,2001,25.0,80,48,36,37,7,32,57,56.1,25,41,8,33,32,112,27,1,Matches
André Onana,393,cmCMR,GK,Manchester Utd,29-037,1996,33.0,1,1,1,0,0,1,3,33.3,2,0,0,0,0,1,11,4,Matches
Andrés García,193,esESP,"DF,MF",Aston Villa,22-091,2003,3.5,9,5,5,3,1,4,8,50.0,4,2,0,2,2,11,10,2,Matches
Andy Irving,249,sctSCO,MF,West Ham,24-361,2000,1.8,7,4,3,3,1,1,5,20.0,4,5,1,4,1,8,5,0,Matches
Anthony Elanga,160,seSWE,"FW,MF",Nott'ham Forest,23-012,2002,24.8,18,13,8,8,2,5,17,29.4,12,11,1,10,6,24,25,0,Matches
Anthony Gordon,208,engENG,FW,Newcastle Utd,24-074,2001,24.8,31,17,9,18,4,12,34,35.3,22,24,2,22,6,37,9,2,Matches
Antoine Semenyo,461,ghGHA,FW,Bournemouth,25-122,2000,32.6,53,34,16,24,13,16,42,38.1,26,59,8,51,10,63,35,1,Matches
Antonee Robinson,434,usUSA,DF,Fulham,27-274,1997,33.2,90,57,53,30,7,44,89,49.4,45,37,7,30,57,147,124,2,Matches
Antony,28,brBRA,"DF,MF",Manchester Utd,25-074,2000,1.6,6,3,4,2,0,2,5,40.0,3,2,0,2,2,8,0,0,Matches
Antonín Kinský,283,czCZE,GK,Tottenham,22-057,2003,4.0,3,1,3,0,0,1,1,100.0,0,0,0,0,0,3,5,1,Matches
Archie Gray,210,engENG,"DF,MF",Tottenham,19-058,2006,16.5,13,7,4,6,3,7,17,41.2,10,19,10,9,13,26,42,2,Matches
Arijanet Muric,366,xkKVX,GK,Ipswich Town,26-183,1998,18.0,0,0,0,0,0,0,2,0.0,2,0,0,0,0,0,10,5,Matches
Armando Broja,70,alALB,FW,Everton,23-241,2001,3.7,3,1,1,1,1,0,0,N/a,0,3,0,3,1,4,4,0,Matches
Armel Bella Kotchap,50,deGER,DF,Southampton,23-149,2001,3.7,7,5,5,2,0,3,6,50.0,3,2,2,0,5,12,21,1,Matches
Asher Agbinone,7,engENG,MF,Crystal Palace,19-223,2005,0.1,2,1,0,2,0,0,0,N/a,0,0,0,0,0,2,0,0,Matches
Ashley Young,564,engENG,"DF,FW",Everton,39-304,1985,18.0,51,29,23,21,7,32,51,62.7,19,10,3,7,23,74,58,1,Matches
Axel Disasi,137,frFRA,DF,Aston Villa,27-059,1998,5.4,8,5,7,1,0,3,7,42.9,4,4,1,3,5,13,18,0,Matches
Axel Tuanzebe,520,cdCOD,DF,Ipswich Town,27-176,1997,16.1,29,17,20,3,6,16,24,66.7,8,18,9,9,21,50,53,1,Matches
Ayden Heaven,230,engENG,DF,Manchester Utd,18-229,2006,1.1,3,3,1,2,0,2,2,100.0,0,2,2,0,1,4,6,0,Matches
Bart Verbruggen,530,nlNED,GK,Brighton,22-264,2002,33.0,0,0,0,0,0,0,3,0.0,3,1,0,1,0,0,28,5,Matches
Ben Brereton,68,clCHI,FW,Southampton,26-021,1999,5.0,3,2,0,2,1,1,9,11.1,8,2,1,1,0,3,4,0,Matches
Ben Chilwell,96,engENG,DF,Crystal Palace,28-139,1996,1.5,4,4,2,2,0,0,3,0.0,3,3,1,2,4,8,11,0,Matches
Ben Davies,122,wlsWAL,DF,Tottenham,32-015,1993,12.5,14,10,6,8,0,7,14,50.0,7,24,16,8,12,26,65,1,Matches
Ben Godfrey,199,engENG,DF,Ipswich Town,27-114,1998,1.8,1,0,1,0,0,1,1,100.0,0,1,1,0,2,3,3,0,Matches
Ben Johnson,263,engENG,"DF,FW",Ipswich Town,25-105,2000,15.0,38,22,23,12,3,20,41,48.8,21,22,5,17,13,51,54,1,Matches
Ben Mee,342,engENG,DF,Brentford,35-230,1989,2.0,2,2,0,2,0,1,1,100.0,0,3,3,0,4,6,7,0,Matches
Ben White,548,engENG,DF,Arsenal,27-213,1997,10.5,13,9,9,2,2,11,28,39.3,17,9,7,2,15,28,35,0,Matches
Ben Winterburn,556,engENG,"FW,MF",Bournemouth,20-247,2004,0.3,0,0,0,0,0,0,1,0.0,1,0,0,0,2,2,0,0,Matches
Benoît Badiashile,42,frFRA,DF,Chelsea,24-044,2001,3.7,9,6,5,4,0,4,5,80.0,1,2,2,0,6,15,12,2,Matches
Bernardo Silva,466,ptPOR,"MF,FW",Manchester City,30-272,1994,26.7,52,34,15,28,9,24,52,46.2,28,33,7,26,20,72,28,3,Matches
Bernd Leno,299,deGER,GK,Fulham,33-066,1992,35.0,2,2,2,0,0,2,2,100.0,0,1,0,1,0,2,9,4,Matches
Beto,57,gwGNB,FW,Everton,27-098,1998,14.1,14,6,2,8,4,5,8,62.5,3,8,1,7,3,17,19,1,Matches
Bilal El Khannouss,279,maMAR,MF,Leicester City,20-364,2004,22.3,46,26,15,26,5,15,28,53.6,13,21,4,17,6,52,9,3,Matches
Billy Gilmour,198,sctSCO,MF,Brighton,23-332,2001,1.1,3,3,2,1,0,3,4,75.0,1,1,0,1,0,3,1,0,Matches
Bobby De Cordova-Reid,126,jmJAM,FW,Leicester City,32-096,1993,8.3,9,4,3,6,0,4,14,28.6,10,6,1,5,0,9,10,0,Matches
Boubacar Kamara,273,frFRA,MF,Aston Villa,25-167,1999,16.3,49,20,28,17,4,28,54,51.9,26,17,7,10,17,66,48,3,Matches
Boubacar Traoré,514,mlMLI,MF,Wolves,23-262,2001,0.0,2,0,0,2,0,1,1,100.0,0,0,0,0,0,2,0,0,Matches
Boubakary Soumaré,480,frFRA,MF,Leicester City,26-071,1999,21.8,33,18,21,11,1,18,30,60.0,12,20,8,12,24,57,31,3,Matches
Brajan Gruda,213,deGER,"FW,MF",Brighton,20-343,2004,5.6,14,6,6,5,3,7,14,50.0,7,8,0,8,2,16,5,1,Matches
Brandon Austin,37,engENG,GK,Tottenham,26-121,1999,1.0,0,0,0,0,0,0,0,N/a,0,0,0,0,0,0,1,0,Matches
Brennan Johnson,264,wlsWAL,FW,Tottenham,23-351,2001,23.1,39,26,9,20,10,16,31,51.6,15,25,3,22,4,43,11,0,Matches
Bruno Fernandes,179,ptPOR,MF,Manchester Utd,30-243,1994,30.6,76,47,24,37,15,29,75,38.7,46,32,4,28,25,101,34,2,Matches
Bruno Guimarães,218,brBRA,MF,Newcastle Utd,27-174,1997,33.4,75,43,36,28,11,31,64,48.4,33,34,9,25,27,102,41,4,Matches
Bryan Mbeumo,335,cmCMR,FW,Brentford,25-275,1999,34.9,45,29,17,14,14,18,31,58.1,13,24,3,21,14,59,48,1,Matches
Bukayo Saka,443,engENG,"FW,MF",Arsenal,23-246,2001,17.1,24,13,7,10,7,11,22,50.0,11,21,0,21,3,27,8,0,Matches
Caleb Kporha,289,engENG,DF,Crystal Palace,18-298,2006,0.1,2,1,2,0,0,2,2,100.0,0,0,0,0,0,2,1,0,Matches
Caleb Okoli,390,itITA,DF,Leicester City,23-300,2001,12.5,25,14,8,15,2,11,18,61.1,7,24,14,10,15,40,79,3,Matches
Callum Hudson-Odoi,241,engENG,"FW,MF",Nott'ham Forest,24-183,2000,23.9,20,14,7,8,5,11,17,64.7,6,11,0,11,13,33,11,1,Matches
Callum Wilson,553,engENG,FW,Newcastle Utd,33-071,1992,3.2,2,2,0,1,1,0,2,0.0,2,2,0,2,1,3,1,0,Matches
Calvin Bassey,47,ngNGA,DF,Fulham,25-129,1999,32.2,52,33,34,18,0,21,30,70.0,9,37,17,20,18,70,105,8,Matches
Cameron Archer,30,engENG,FW,Southampton,23-292,2001,15.3,11,7,6,3,2,2,9,22.2,7,5,1,4,2,13,9,0,Matches
Cameron Burgess,75,auAUS,DF,Ipswich Town,29-200,1995,16.1,15,10,12,3,0,7,9,77.8,2,18,13,5,14,29,116,3,Matches
Caoimhín Kelleher,276,ieIRL,GK,Liverpool,26-167,1998,10.0,0,0,0,0,0,0,0,N/a,0,0,0,0,0,0,1,2,Matches
Carlos Alcaraz,13,arARG,MF,Southampton,22-160,2002,0.1,0,0,0,0,0,0,0,N/a,0,0,0,0,1,1,0,0,Matches
Carlos Baleba,44,cmCMR,MF,Brighton,21-126,2004,26.7,71,41,24,32,15,44,72,61.1,28,44,10,34,40,111,41,1,Matches
Carlos Forbs,185,ptPOR,"MF,FW",Wolves,21-051,2004,2.7,8,5,5,2,1,4,6,66.7,2,3,0,3,1,9,2,1,Matches
Carlos Soler,476,esESP,"MF,FW",West Ham,28-127,1997,15.1,15,11,8,6,1,7,23,30.4,16,19,6,13,8,23,21,2,Matches
Carlos Vinícius,533,brBRA,"MF,FW",Fulham,30-045,1995,0.2,0,0,0,0,0,0,1,0.0,1,1,0,1,0,0,0,0,Matches
Casemiro,86,brBRA,MF,Manchester Utd,33-075,1992,14.8,77,46,45,23,9,41,66,62.1,25,33,10,23,12,89,48,3,Matches
Chadi Riad,429,maMAR,DF,Crystal Palace,21-326,2003,1.0,5,2,2,2,1,2,3,66.7,1,0,0,0,2,7,0,0,Matches
Charlie Taylor,498,engENG,DF,Southampton,31-233,1993,3.0,7,5,4,3,0,5,6,83.3,1,5,3,2,3,10,22,1,Matches
Cheick Doucouré,147,mlMLI,MF,Crystal Palace,25-121,2000,5.0,16,8,6,8,2,5,11,45.5,6,4,0,4,11,27,10,1,Matches
Chidozie Obi-Martin,387,dkDEN,FW,Manchester Utd,17-161,2007,1.7,2,1,0,0,2,2,2,100.0,0,0,0,0,0,2,1,0,Matches
Chiedozie Ogbene,389,ieIRL,FW,Ipswich Town,28-008,1997,2.6,7,3,1,2,4,2,4,50.0,2,1,0,1,1,8,3,0,Matches
Chiquinho,97,ptPOR,MF,Wolves,25-093,2000,0.1,0,0,0,0,0,0,0,N/a,0,0,0,0,0,0,0,0,Matches
Chris Richards,431,usUSA,DF,Crystal Palace,25-042,2000,18.4,44,28,21,17,6,23,38,60.5,15,36,13,23,15,59,98,0,Matches
Chris Wood,558,nzNZL,FW,Nott'ham Forest,33-153,1991,29.9,5,4,1,2,2,2,9,22.2,7,11,7,4,5,10,26,1,Matches
Christian Eriksen,166,dkDEN,MF,Manchester Utd,33-084,1992,11.4,19,9,4,12,3,11,26,42.3,15,14,4,10,7,26,7,0,Matches
Christian Nørgaard,383,dkDEN,MF,Brentford,31-060,1994,28.3,75,45,34,34,7,44,71,62.0,27,51,19,32,45,120,65,1,Matches
Christian Walton,536,engENG,GK,Ipswich Town,29-181,1995,6.0,0,0,0,0,0,0,1,0.0,1,0,0,0,0,0,1,1,Matches
Christopher Nkunku,378,frFRA,FW,Chelsea,27-176,1997,10.2,12,8,3,4,5,6,8,75.0,2,9,2,7,7,19,10,0,Matches
Cody Gakpo,191,nlNED,FW,Liverpool,26-002,1999,19.1,26,14,5,12,9,11,23,47.8,12,19,2,17,11,37,16,1,Matches
Cole Palmer,402,engENG,MF,Chelsea,23-003,2002,32.5,27,17,11,9,7,9,23,39.1,14,14,1,13,11,38,18,1,Matches
Conor Bradley,65,nirNIR,DF,Liverpool,21-304,2003,6.3,11,8,5,4,2,8,17,47.1,9,4,0,4,3,14,21,0,Matches
Conor Chaplin,93,engENG,"MF,FW",Ipswich Town,28-082,1997,7.9,12,5,4,6,2,6,13,46.2,7,8,1,7,3,15,3,0,Matches
Conor Coady,103,engENG,DF,Leicester City,32-073,1993,16.0,12,8,6,5,1,3,6,50.0,3,27,20,7,13,25,62,2,Matches
Conor Townsend,512,engENG,DF,Ipswich Town,32-066,1993,3.7,11,8,9,2,0,8,11,72.7,3,8,6,2,4,15,16,0,Matches
Craig Dawson,124,engENG,DF,Wolves,35-003,1990,10.8,15,3,8,6,1,12,15,80.0,3,16,11,5,9,24,52,1,Matches
Cristian Romero,440,arARG,DF,Tottenham,27-012,1998,15.7,35,29,26,8,1,21,30,70.0,9,18,3,15,21,56,57,2,Matches
Crysencio Summerville,492,nlNED,"FW,MF",West Ham,23-191,2001,8.7,13,7,2,8,3,3,9,33.3,6,13,4,9,0,13,7,0,Matches
Curtis Jones,266,engENG,"MF,DF",Liverpool,24-099,2001,17.0,36,20,6,22,8,17,25,68.0,8,16,7,9,6,42,8,2,Matches
Daichi Kamada,272,jpJPN,MF,Crystal Palace,28-277,1996,15.8,45,27,19,22,4,13,38,34.2,25,21,5,16,16,61,14,0,Matches
Dan Burn,76,engENG,DF,Newcastle Utd,33-000,1992,34.0,34,19,20,12,2,17,32,53.1,15,32,23,9,25,59,180,3,Matches
Dane Scarlett,454,engENG,"FW,MF",Tottenham,21-046,2004,0.4,1,0,0,1,0,0,0,N/a,0,0,0,0,0,1,1,0,Matches
Dango Ouattara,399,bfBFA,FW,Bournemouth,23-087,2002,22.3,35,26,14,11,10,17,41,41.5,24,36,10,26,11,46,51,0,Matches
Daniel Bentley,53,engENG,GK,Wolves,31-300,1993,1.0,0,0,0,0,0,0,0,N/a,0,0,0,0,0,0,0,0,Matches
Daniel Jebbison,256,engENG,FW,Bournemouth,21-269,2003,0.9,3,2,2,1,0,3,5,60.0,2,2,1,1,1,4,1,0,Matches
Daniel Muñoz,365,coCOL,DF,Crystal Palace,28-348,1996,32.9,113,74,53,37,23,52,89,58.4,37,36,4,32,40,153,102,1,Matches
Daniel Podence,414,ptPOR,"MF,FW",Wolves,29-200,1995,0.5,0,0,0,0,0,0,1,0.0,1,0,0,0,0,0,0,0,Matches
Danilo,119,brBRA,"MF,FW",Nott'ham Forest,24-010,2001,3.0,6,3,5,1,0,2,4,50.0,2,2,1,1,3,9,3,0,Matches
Danny Ings,247,engENG,"FW,MF",West Ham,32-290,1992,3.2,4,2,2,2,0,1,3,33.3,2,5,0,5,1,5,4,0,Matches
Danny Ward,538,wlsWAL,GK,Leicester City,31-321,1993,1.5,0,0,0,0,0,0,0,N/a,0,0,0,0,0,0,1,0,Matches
Danny Welbeck,544,engENG,FW,Brighton,34-164,1990,21.6,23,14,6,12,5,7,18,38.9,11,17,2,15,5,28,13,0,Matches
Dara O'Shea,386,ieIRL,DF,Ipswich Town,26-066,1999,31.7,47,30,33,11,3,20,31,64.5,11,59,47,12,31,78,204,4,Matches
Darwin Núñez,381,uyURU,FW,Liverpool,25-319,1999,11.7,19,16,11,3,5,6,16,37.5,10,6,0,6,3,22,12,0,Matches
David Brooks,71,wlsWAL,"FW,MF",Bournemouth,27-305,1997,9.2,11,4,2,6,3,1,14,7.1,13,16,2,14,5,16,8,1,Matches
David Raya,424,esESP,GK,Arsenal,29-236,1995,35.0,0,0,0,0,0,0,2,0.0,2,0,0,0,2,2,18,6,Matches
Dean Henderson,233,engENG,GK,Crystal Palace,28-058,1997,35.0,2,1,2,0,0,2,6,33.3,4,0,0,0,0,2,21,0,Matches
Dean Huijsen,243,esESP,DF,Bournemouth,20-025,2005,24.8,33,23,16,16,1,15,25,60.0,10,36,28,8,49,82,175,4,Matches
Declan Rice,430,engENG,MF,Arsenal,26-115,1999,29.4,52,24,21,25,6,16,37,43.2,21,24,11,13,25,77,44,0,Matches
Dejan Kulusevski,292,seSWE,"MF,FW",Tottenham,25-014,2000,26.3,45,23,17,13,15,19,51,37.3,32,34,5,29,13,58,10,1,Matches
Destiny Udogie,521,itITA,DF,Tottenham,22-162,2002,20.4,74,47,41,26,7,33,47,70.2,14,40,6,34,21,95,35,1,Matches
Diego Carlos,84,brBRA,DF,Aston Villa,32-055,1993,9.2,8,3,6,1,1,4,6,66.7,2,13,7,6,5,13,36,2,Matches
Diego Gómez,205,pyPAR,MF,Brighton,22-043,2003,4.9,17,10,8,7,2,9,18,50.0,9,11,0,11,7,24,9,1,Matches
Diogo Dalot,117,ptPOR,DF,Manchester Utd,26-052,1999,31.0,67,39,39,22,6,34,52,65.4,18,22,9,13,37,104,72,0,Matches
Diogo Jota,268,ptPOR,FW,Liverpool,28-156,1996,12.8,14,8,2,8,4,7,19,36.8,12,9,0,9,7,21,6,0,Matches
Divin Mubama,361,engENG,FW,Manchester City,20-196,2004,0.3,0,0,0,0,0,0,0,N/a,0,0,0,0,0,0,0,0,Matches
Djed Spence,481,engENG,DF,Tottenham,24-273,2000,17.8,40,30,22,12,6,20,27,74.1,7,24,9,15,18,58,64,1,Matches
Dominic Calvert-Lewin,83,engENG,FW,Everton,28-054,1997,17.6,9,7,1,4,4,2,6,33.3,4,6,2,4,6,15,19,0,Matches
Dominic Solanke,475,engENG,FW,Tottenham,27-237,1997,23.5,18,11,1,12,5,4,14,28.6,10,18,7,11,0,18,22,0,Matches
Dominik Szoboszlai,494,huHUN,MF,Liverpool,24-196,2000,25.3,31,20,10,16,5,15,39,38.5,24,36,4,32,9,40,17,2,Matches
Donyell Malen,322,nlNED,FW,Aston Villa,26-120,1999,3.3,7,4,3,3,1,1,4,25.0,3,1,0,1,0,7,1,0,Matches
Dwight McNeil,340,engENG,"MF,FW",Everton,25-168,1999,14.0,11,6,5,4,2,8,19,42.1,11,7,0,7,5,16,2,1,Matches
Eberechi Eze,172,engENG,"MF,FW",Crystal Palace,26-314,1998,27.0,37,22,13,15,9,17,35,48.6,18,27,0,27,11,48,9,3,Matches
Eddie Nketiah,377,engENG,"FW,MF",Crystal Palace,25-344,1999,9.9,13,6,6,3,4,6,12,50.0,6,10,1,9,2,15,11,0,Matches
Ederson,154,brBRA,GK,Manchester City,31-265,1993,22.8,0,0,0,0,0,0,2,0.0,2,0,0,0,1,1,9,2,Matches
Edmond-Paris Maghoma,318,engENG,"MF,FW",Brentford,24-001,2001,1.3,2,1,0,2,0,1,3,33.3,2,2,2,0,1,3,2,0,Matches
Edson Álvarez,18,mxMEX,MF,West Ham,27-197,1997,18.1,44,23,24,12,8,15,33,45.5,18,21,8,13,16,60,39,1,Matches
Eiran Cashin,89,ieIRL,DF,Brighton,23-181,2001,0.2,0,0,0,0,0,0,1,0.0,1,0,0,0,0,0,2,0,Matches
Elliot Anderson,25,engENG,MF,Nott'ham Forest,22-184,2002,27.4,84,52,50,27,7,43,100,43.0,57,44,9,35,30,114,67,4,Matches
Emerson Palmieri,403,itITA,DF,West Ham,30-279,1994,23.4,60,31,37,18,5,27,48,56.3,21,32,8,24,21,81,59,0,Matches
Emi Buendía,72,arARG,"MF,FW",Aston Villa,28-135,1996,1.1,6,6,3,2,1,0,5,0.0,5,5,1,4,0,6,2,0,Matches
Emil Krafth,290,seSWE,DF,Newcastle Utd,30-280,1994,3.2,4,2,2,1,1,2,3,66.7,1,5,4,1,2,6,11,0,Matches
Emile Smith Rowe,474,engENG,MF,Fulham,24-285,2000,21.0,31,18,7,14,10,8,24,33.3,16,20,2,18,11,42,16,0,Matches
Emiliano Martínez,328,arARG,GK,Aston Villa,32-249,1992,33.0,3,3,3,0,0,2,2,100.0,0,1,0,1,0,3,17,6,Matches
Emmanuel Agbadou,6,ciCIV,DF,Wolves,27-326,1997,12.7,27,18,18,9,0,11,17,64.7,6,16,12,4,9,36,77,0,Matches
Enes Ünal,524,trTUR,"FW,MF",Bournemouth,27-364,1997,3.8,1,0,0,0,1,0,3,0.0,3,1,0,1,0,1,6,0,Matches
Enzo Fernández,181,arARG,MF,Chelsea,24-112,2001,29.7,63,32,17,29,17,31,83,37.3,52,36,7,29,13,76,22,4,Matches
Eric da Silva Moreira,468,deGER,"MF,DF",Nott'ham Forest,19-006,2006,0.3,2,2,2,0,0,2,6,33.3,4,0,0,0,1,3,0,0,Matches
Erling Haaland,223,noNOR,FW,Manchester City,24-292,2000,27.6,9,5,3,3,3,2,6,33.3,4,11,1,10,5,14,23,0,Matches
Ethan Nwaneri,382,engENG,"FW,MF",Arsenal,18-049,2007,9.1,11,7,4,4,3,7,18,38.9,11,8,2,6,2,13,4,1,Matches
Ethan Pinnock,413,jmJAM,DF,Brentford,31-345,1993,21.3,35,19,15,16,4,13,24,54.2,11,29,18,11,24,59,142,4,Matches
Evan Ferguson,177,ieIRL,FW,West Ham,20-202,2004,1.7,3,1,0,1,2,0,0,N/a,0,2,1,1,1,4,1,0,Matches
Evanilson,169,brBRA,FW,Bournemouth,25-215,1999,22.9,16,10,6,5,5,8,12,66.7,4,10,2,8,0,16,21,0,Matches
Ezri Konsa,287,engENG,DF,Aston Villa,27-198,1997,29.6,32,17,19,9,4,18,22,81.8,4,18,10,8,21,53,101,4,Matches
Fabian Schär,456,chSUI,DF,Newcastle Utd,33-140,1991,29.6,34,21,15,17,2,14,34,41.2,20,37,24,13,41,75,116,3,Matches
Fabio Carvalho,85,ptPOR,"FW,MF",Brentford,22-252,2002,5.1,13,9,4,4,5,6,13,46.2,7,6,1,5,3,16,2,0,Matches
Facundo Buonanotte,74,arARG,"FW,MF",Leicester City,20-137,2004,16.4,53,32,17,22,14,21,67,31.3,46,32,6,26,11,64,14,0,Matches
Federico Chiesa,95,itITA,FW,Liverpool,27-196,1997,0.5,0,0,0,0,0,0,2,0.0,2,1,0,1,0,0,0,1,Matches
Ferdi Kadioglu,271,trTUR,"DF,MF",Brighton,25-214,1999,4.3,10,6,4,5,1,6,15,40.0,9,2,2,0,8,18,17,0,Matches
Filip Jørgensen,270,dkDEN,GK,Chelsea,23-023,2002,6.0,0,0,0,0,0,0,0,N/a,0,0,0,0,0,0,0,3,Matches
Flynn Downes,148,engENG,MF,Southampton,26-109,1999,20.9,44,24,19,20,5,14,32,43.8,18,24,6,18,30,74,38,4,Matches
Frank Onyeka,395,ngNGA,MF,Brentford,27-128,1998,0.3,0,0,0,0,0,0,0,N/a,0,0,0,0,0,0,0,0,Matches
Fraser Forster,186,engENG,GK,Tottenham,37-053,1988,7.0,0,0,0,0,0,0,1,0.0,1,0,0,0,0,0,7,3,Matches
Gabriel Jesus,258,brBRA,FW,Arsenal,28-036,1997,6.8,10,6,4,3,3,4,9,44.4,5,10,1,9,4,14,8,0,Matches
Gabriel Magalhães,317,brBRA,DF,Arsenal,27-141,1997,26.3,25,15,12,8,5,12,16,75.0,4,42,29,13,16,41,93,2,Matches
Gabriel Martinelli,327,brBRA,"FW,MF",Arsenal,23-325,2001,22.7,20,15,8,5,7,7,23,30.4,16,10,0,10,4,24,15,0,Matches
George Edmundson,155,engENG,DF,Ipswich Town,27-251,1997,0.0,0,0,0,0,0,0,0,N/a,0,0,0,0,0,0,0,0,Matches
George Hirst,239,sctSCO,FW,Ipswich Town,26-083,1999,5.5,3,3,1,0,2,1,3,33.3,2,1,1,0,2,5,9,0,Matches
Georginio Rutter,441,frFRA,"MF,FW",Brighton,23-019,2002,18.4,39,15,13,18,8,14,36,38.9,22,20,3,17,10,49,13,2,Matches
Gonçalo Guedes,215,ptPOR,"MF,FW",Wolves,28-161,1996,8.7,14,4,2,5,7,3,15,20.0,12,9,0,9,5,19,3,0,Matches
Guglielmo Vicario,532,itITA,GK,Tottenham,28-214,1996,23.0,0,0,0,0,0,0,0,N/a,0,0,0,0,1,1,14,6,Matches
Guido Rodríguez,437,arARG,MF,West Ham,31-027,1994,11.3,30,16,19,11,0,14,30,46.7,16,21,9,12,12,42,28,1,Matches
Gustavo Nunes,379,brBRA,"FW,MF",Brentford,19-170,2005,0.1,3,2,2,0,1,2,2,100.0,0,0,0,0,0,3,2,0,Matches
Hamza Choudhury,98,bdBAN,"MF,DF",Leicester City,27-220,1997,1.5,1,1,1,0,0,1,3,33.3,2,4,2,2,5,6,2,0,Matches
Harrison Armstrong,34,engENG,MF,Everton,18-110,2007,0.5,0,0,0,0,0,0,1,0.0,1,0,0,0,0,0,1,0,Matches
Harrison Reed,425,engENG,MF,Fulham,30-102,1995,1.2,6,3,3,2,1,1,3,33.3,2,1,0,1,1,7,3,0,Matches
Harry Amass,20,engENG,DF,Manchester Utd,18-054,2007,2.8,6,2,5,1,0,2,6,33.3,4,6,1,5,2,8,10,0,Matches
Harry Clarke,100,engENG,DF,Ipswich Town,24-068,2001,4.2,5,3,3,2,0,3,6,50.0,3,5,4,1,4,9,14,3,Matches
Harry Maguire,319,engENG,DF,Manchester Utd,32-065,1993,17.1,26,13,20,5,1,13,18,72.2,5,14,12,2,37,63,72,1,Matches
Harry Toffolo,508,engENG,DF,Nott'ham Forest,29-263,1995,1.5,5,3,3,1,1,3,4,75.0,1,2,2,0,2,7,12,0,Matches
Harry Wilson,554,wlsWAL,"FW,MF",Fulham,28-048,1997,11.1,14,9,8,3,3,9,15,60.0,6,13,1,12,5,19,7,1,Matches
Harry Winks,555,engENG,MF,Leicester City,29-096,1996,17.1,24,11,12,10,2,13,30,43.3,17,19,7,12,9,33,20,0,Matches
Harvey Barnes,46,engENG,FW,Newcastle Utd,27-151,1997,16.7,16,9,4,6,6,3,10,30.0,7,7,1,6,6,22,12,1,Matches
Harvey Elliott,161,engENG,"MF,FW",Liverpool,22-035,2003,3.0,4,3,2,1,1,1,5,20.0,4,5,1,4,1,5,2,0,Matches
Hwang Hee-chan,232,krKOR,"MF,FW",Wolves,29-103,1996,7.2,6,4,2,1,3,2,6,33.3,4,9,0,9,2,8,11,0,Matches
Hákon Rafn Valdimarsson,419,isISL,GK,Brentford,23-208,2001,1.6,0,0,0,0,0,0,0,N/a,0,0,0,0,0,0,2,0,Matches
Ian Maatsen,313,nlNED,DF,Aston Villa,23-060,2002,10.6,27,15,16,8,3,16,22,72.7,6,11,0,11,15,42,33,2,Matches
Ibrahim Sangaré,448,ciCIV,MF,Nott'ham Forest,27-158,1997,4.1,19,11,5,13,1,4,12,33.3,8,8,3,5,3,22,6,1,Matches
Ibrahima Konaté,286,frFRA,DF,Liverpool,25-349,1999,25.8,36,25,24,11,1,24,34,70.6,10,27,15,12,12,48,124,2,Matches
Idrissa Gana Gueye,192,snSEN,MF,Everton,35-225,1989,31.0,124,74,57,51,16,54,90,60.0,36,45,9,36,44,168,30,1,Matches
Igor,246,brBRA,DF,Brighton,27-091,1998,10.0,4,4,2,1,1,4,10,40.0,6,23,14,9,4,8,39,1,Matches
Iliman Ndiaye,370,snSEN,FW,Everton,25-064,2000,25.0,48,25,18,15,15,19,45,42.2,26,27,5,22,17,65,24,1,Matches
Illia Zabarnyi,565,uaUKR,DF,Bournemouth,22-250,2002,31.6,46,32,26,19,1,30,44,68.2,14,33,20,13,38,84,165,2,Matches
Ismaila Sarr,451,snSEN,"MF,FW",Crystal Palace,27-073,1998,27.6,21,10,9,9,3,7,23,30.4,16,24,8,16,9,30,36,0,Matches
Issa Diop,136,frFRA,DF,Fulham,28-120,1997,14.9,26,12,18,8,0,13,18,72.2,5,10,7,3,9,35,72,2,Matches
Jack Clarke,101,engENG,"FW,MF",Ipswich Town,24-167,2000,11.7,28,17,11,9,8,16,32,50.0,16,6,0,6,7,35,29,1,Matches
Jack Grealish,211,engENG,"FW,MF",Manchester City,29-241,1995,8.0,9,5,4,2,3,2,5,40.0,3,12,2,10,2,11,5,1,Matches
Jack Harrison,227,engENG,FW,Everton,28-170,1996,21.1,30,21,12,11,7,14,40,35.0,26,18,2,16,9,39,32,2,Matches
Jack Hinshelwood,238,engENG,"DF,MF",Brighton,20-028,2005,19.4,26,18,8,10,8,11,27,40.7,16,8,3,5,15,41,37,1,Matches
Jack Stephens,484,engENG,DF,Southampton,31-102,1994,13.4,32,19,23,9,0,15,27,55.6,12,15,10,5,11,43,44,2,Matches
Jack Taylor,499,ieIRL,MF,Ipswich Town,26-320,1998,8.5,20,10,6,11,3,12,23,52.2,11,10,3,7,9,29,23,0,Matches
Jacob Greaves,212,engENG,DF,Ipswich Town,24-239,2000,21.5,36,19,19,16,1,21,33,63.6,12,36,24,12,18,54,127,2,Matches
Jacob Murphy,368,engENG,FW,Newcastle Utd,30-074,1995,23.8,22,15,7,9,6,16,31,51.6,15,31,0,31,11,33,26,1,Matches
Jacob Ramsey,421,engENG,"FW,MF",Aston Villa,23-346,2001,16.8,30,15,14,10,6,10,20,50.0,10,21,3,18,7,37,8,1,Matches
Jaden Philogene Bidace,410,engENG,"FW,MF",Aston Villa,23-090,2002,3.7,11,5,4,7,0,4,6,66.7,2,5,0,5,3,14,2,1,Matches
Jadon Sancho,447,engENG,FW,Chelsea,25-045,2000,18.7,10,6,3,2,5,5,12,41.7,7,9,0,9,2,12,6,2,Matches
Jahmai Simpson-Pusey,469,engENG,DF,Manchester City,19-186,2005,1.1,1,0,1,0,0,0,1,0.0,1,1,1,0,0,1,2,0,Matches
Jake Evans,170,N/a,FW,Leicester City,N/a,N/a,0.1,0,0,0,0,0,0,1,0.0,1,0,0,0,0,0,1,0,Matches
Jake O'Brien,384,ieIRL,DF,Everton,23-359,2001,15.5,24,16,19,5,0,16,24,66.7,8,16,4,12,4,28,80,0,Matches
Jakub Kiwior,284,plPOL,DF,Arsenal,25-083,2000,9.5,13,7,7,5,1,8,11,72.7,3,8,5,3,3,16,37,2,Matches
Jakub Moder,353,plPOL,MF,Brighton,26-032,1999,0.1,1,0,1,0,0,0,2,0.0,2,0,0,0,0,1,3,0,Matches
Jakub Stolarczyk,487,plPOL,GK,Leicester City,24-141,2000,7.0,2,1,2,0,0,1,2,50.0,1,0,0,0,0,2,5,0,Matches
James Bree,67,engENG,DF,Southampton,27-210,1997,9.9,15,10,5,9,1,7,17,41.2,10,8,3,5,8,23,24,0,Matches
James Garner,195,engENG,"MF,DF",Everton,24-057,2001,14.7,41,27,24,15,2,19,35,54.3,16,15,3,12,17,58,36,0,Matches
James Hill,237,engENG,DF,Bournemouth,23-119,2002,5.0,15,8,6,6,3,3,11,27.3,8,5,0,5,9,24,31,0,Matches
James Justin,269,engENG,DF,Leicester City,27-075,1998,29.7,49,29,25,19,5,28,51,54.9,23,41,14,27,44,93,129,3,Matches
James Maddison,315,engENG,MF,Tottenham,28-167,1996,20.1,31,19,8,16,7,9,29,31.0,20,15,4,11,12,43,19,1,Matches
James Mcatee,336,engENG,"MF,FW",Manchester City,22-203,2002,3.4,4,2,0,4,0,1,7,14.3,6,8,0,8,2,6,1,0,Matches
James Milner,348,engENG,MF,Brighton,39-125,1986,1.9,5,2,1,3,1,3,3,100.0,0,4,2,2,2,7,2,1,Matches
James Tarkowski,496,engENG,DF,Everton,32-171,1992,32.5,64,40,39,22,3,24,39,61.5,15,57,42,15,41,105,213,4,Matches
James Ward-Prowse,540,engENG,MF,West Ham,30-189,1994,9.0,15,10,7,5,3,4,13,30.8,9,6,3,3,5,20,13,0,Matches
Jamie Vardy,526,engENG,FW,Leicester City,38-118,1987,29.5,18,13,6,7,5,4,13,30.8,9,8,4,4,5,23,23,0,Matches
Jan Bednarek,49,plPOL,DF,Southampton,29-027,1996,27.1,35,18,22,13,0,15,30,50.0,15,44,33,11,54,89,177,5,Matches
Jan Paul van Hecke,231,nlNED,DF,Brighton,24-335,2000,29.9,40,26,20,19,1,20,38,52.6,18,32,19,13,23,63,132,2,Matches
Jannik Vestergaard,531,dkDEN,DF,Leicester City,32-279,1992,15.5,22,10,16,6,0,9,15,60.0,6,21,14,7,16,38,74,1,Matches
Jarell Quansah,418,engENG,DF,Liverpool,22-100,2003,4.5,11,8,8,3,0,6,8,75.0,2,8,7,1,6,17,18,1,Matches
Jarrad Branthwaite,66,engENG,DF,Everton,22-316,2002,26.1,36,20,26,10,0,20,27,74.1,7,30,22,8,23,59,183,4,Matches
Jarrod Bowen,64,engENG,"FW,MF",West Ham,28-140,1996,30.2,37,24,13,10,14,17,37,45.9,20,21,3,18,16,53,23,0,Matches
Jason Steele,483,engENG,GK,Brighton,34-264,1990,2.0,0,0,0,0,0,0,0,N/a,0,0,0,0,0,0,1,0,Matches
Jay Robinson,435,engENG,"MF,FW",Southampton,18-055,2007,0.4,2,1,2,0,0,0,0,N/a,0,0,0,0,0,2,0,0,Matches
Jay Stansfield,482,engENG,MF,Fulham,22-166,2002,0.0,0,0,0,0,0,0,0,N/a,0,0,0,0,0,0,0,0,Matches
Jayden Danns,120,engENG,MF,Liverpool,19-113,2006,0.1,0,0,0,0,0,0,1,0.0,1,0,0,0,0,0,0,0,Matches
Jayden Meghoma,343,engENG,DF,Brentford,18-315,2006,0.1,0,0,0,0,0,0,0,N/a,0,0,0,0,0,0,0,0,Matches
Jean-Clair Todibo,507,frFRA,DF,West Ham,25-130,1999,17.4,40,24,26,13,1,25,33,75.8,8,24,12,12,21,61,70,3,Matches
Jean-Philippe Mateta,331,frFRA,FW,Crystal Palace,27-315,1997,28.0,17,12,4,11,2,3,16,18.8,13,16,3,13,2,19,22,0,Matches
Jean-Ricner Bellegarde,51,frFRA,"MF,FW",Wolves,26-316,1998,17.2,37,22,17,17,3,13,19,68.4,6,19,3,16,10,47,17,1,Matches
Jefferson Lerma,300,coCOL,"MF,DF",Crystal Palace,30-196,1994,22.6,30,15,12,14,4,17,33,51.5,16,32,15,17,37,67,63,1,Matches
Jeffrey Schlupp,457,ghGHA,"MF,DF",Crystal Palace,32-137,1992,1.1,2,0,1,0,1,0,3,0.0,3,6,0,6,0,2,2,0,Matches
Jens Cajuste,81,seSWE,MF,Ipswich Town,25-272,1999,19.8,39,19,18,20,1,19,47,40.4,28,24,9,15,25,64,33,2,Matches
Jeremy Doku,142,beBEL,"FW,MF",Manchester City,22-347,2002,15.5,28,19,9,12,7,7,14,50.0,7,10,1,9,4,32,2,0,Matches
Jeremy Monga,354,N/a,"FW,MF",Leicester City,N/a,N/a,0.6,1,1,0,1,0,1,1,100.0,0,3,2,1,0,1,1,0,Matches
Jeremy Sarmiento,450,ecECU,MF,Brighton,22-327,2002,0.1,0,0,0,0,0,0,0,N/a,0,0,0,0,0,0,0,0,Matches
Jesper Lindstrøm,307,dkDEN,FW,Everton,25-069,2000,13.8,45,25,24,19,2,19,55,34.5,36,15,3,12,12,57,17,0,Matches
Joachim Andersen,23,dkDEN,DF,Crystal Palace,28-343,1996,1.0,1,1,1,0,0,1,2,50.0,1,0,0,0,0,1,7,0,Matches
Joe Aribo,32,ngNGA,"MF,DF",Southampton,28-292,1996,21.2,44,30,15,23,6,17,34,50.0,17,24,9,15,20,64,29,3,Matches
Joe Gomez,206,engENG,DF,Liverpool,27-351,1997,5.8,13,10,5,7,1,11,16,68.8,5,9,6,3,7,20,20,2,Matches
Joe Lumley,311,engENG,GK,Southampton,30-083,1995,3.0,0,0,0,0,0,0,0,N/a,0,0,0,0,0,0,3,3,Matches
Joe Willock,552,engENG,"MF,FW",Newcastle Utd,25-262,1999,11.4,28,16,15,10,3,18,29,62.1,11,24,6,18,6,34,7,0,Matches
Joel Ward,539,engENG,DF,Crystal Palace,35-192,1989,0.0,0,0,0,0,0,0,0,N/a,0,0,0,0,0,0,0,0,Matches
Joelinton,262,brBRA,"MF,FW",Newcastle Utd,28-268,1996,26.6,57,35,23,23,11,25,44,56.8,19,37,7,30,23,80,47,2,Matches
John McGinn,339,sctSCO,"MF,FW",Aston Villa,30-203,1994,22.8,31,22,10,13,8,11,27,40.7,16,21,2,19,14,45,16,3,Matches
John Stones,488,engENG,"DF,MF",Manchester City,30-346,1994,6.1,6,2,3,2,1,5,5,100.0,0,5,3,2,4,10,19,1,Matches
Jonny Evans,171,nirNIR,DF,Manchester Utd,37-126,1988,3.2,7,5,4,3,0,2,4,50.0,2,2,1,1,4,11,13,0,Matches
Jordan Ayew,40,ghGHA,"FW,MF",Crystal Palace,33-240,1991,0.2,1,0,0,0,1,0,0,N/a,0,0,0,0,0,1,0,0,Matches
Jordan Pickford,412,engENG,GK,Everton,31-063,1994,35.0,1,0,1,0,0,1,2,50.0,1,0,0,0,1,2,29,2,Matches
Jorge Cuenca,114,esESP,DF,Fulham,25-173,1999,2.9,2,2,2,0,0,2,5,40.0,3,3,3,0,2,4,21,0,Matches
Jorginho,267,itITA,MF,Arsenal,33-140,1991,7.8,12,4,1,7,4,8,20,40.0,12,3,0,3,7,19,2,2,Matches
Joshua Acheampong,2,engENG,DF,Chelsea,19-004,2006,1.9,2,1,2,0,0,2,2,100.0,0,1,0,1,1,3,2,0,Matches
Joshua King,282,engENG,"MF,FW",Fulham,18-126,2007,0.9,5,3,2,3,0,0,2,0.0,2,2,0,2,1,6,1,0,Matches
Joshua Zirkzee,567,nlNED,"FW,MF",Manchester Utd,23-352,2001,15.6,14,8,3,8,3,5,10,50.0,5,15,4,11,6,20,8,1,Matches
José Sá,442,ptPOR,GK,Wolves,32-112,1993,27.0,2,2,2,0,0,2,2,100.0,0,0,0,0,0,2,14,1,Matches
Jota Silva,467,ptPOR,"FW,MF",Nott'ham Forest,25-281,1999,9.4,25,13,12,11,2,5,25,20.0,20,9,1,8,12,37,17,0,Matches
João Félix,176,ptPOR,"FW,MF",Chelsea,25-180,1999,4.1,8,3,2,5,1,5,9,55.6,4,2,0,2,3,11,2,0,Matches
João Gomes,202,brBRA,MF,Wolves,24-086,2001,30.9,105,62,53,48,4,42,102,41.2,60,42,4,38,25,130,32,0,Matches
João Pedro,261,brBRA,"FW,MF",Brighton,23-225,2001,21.6,16,12,6,6,4,4,11,36.4,7,12,0,12,9,25,12,0,Matches
Joël Veltman,528,nlNED,DF,Brighton,33-114,1992,18.5,42,28,23,16,3,30,51,58.8,21,22,7,15,18,60,66,0,Matches
Joško Gvardiol,222,hrCRO,DF,Manchester City,23-106,2002,33.4,51,34,24,17,10,19,37,51.4,18,40,20,20,38,89,117,8,Matches
Julian Araujo,29,mxMEX,DF,Bournemouth,23-269,2001,4.7,8,3,4,4,0,5,12,41.7,7,3,0,3,6,14,16,0,Matches
Julio Enciso,163,pyPAR,"FW,MF",Ipswich Town,21-106,2004,7.9,11,8,2,6,3,4,9,44.4,5,3,0,3,1,12,4,0,Matches
Julio Soler,477,arARG,FW,Bournemouth,20-082,2005,0.0,1,1,1,0,0,1,1,100.0,0,1,0,1,0,1,0,0,Matches
Jurriën Timber,506,nlNED,DF,Arsenal,23-326,2001,26.9,58,38,17,30,11,18,27,66.7,9,19,4,15,22,80,44,1,Matches
Justin Devenny,129,nirNIR,MF,Crystal Palace,21-210,2003,4.8,14,9,6,7,1,7,14,50.0,7,3,0,3,0,14,10,0,Matches
Justin Kluivert,285,nlNED,"MF,FW",Bournemouth,26-004,1999,24.0,21,9,4,10,7,4,21,19.0,17,24,0,24,13,34,23,1,Matches
Jáder Durán,153,coCOL,FW,Aston Villa,21-147,2003,7.1,8,7,1,2,5,1,4,25.0,3,5,0,5,0,8,13,0,Matches
Jørgen Strand Larsen,489,noNOR,FW,Wolves,25-092,2000,27.4,9,6,2,3,4,4,27,14.8,23,18,4,14,5,14,27,0,Matches
Kaelan Casey,87,engENG,DF,West Ham,20-193,2004,0.0,0,0,0,0,0,0,0,N/a,0,0,0,0,0,0,1,0,Matches
Kai Havertz,229,deGER,"FW,MF",Arsenal,25-332,1999,20.4,16,9,3,6,7,4,15,26.7,11,22,4,18,6,22,31,1,Matches
Kalvin Phillips,409,engENG,MF,Ipswich Town,29-158,1995,13.7,35,19,8,20,7,15,39,38.5,24,35,6,29,19,54,37,2,Matches
Kamaldeen Sulemana,491,ghGHA,"FW,MF",Southampton,23-083,2002,13.1,16,14,6,4,6,8,13,61.5,5,9,0,9,6,22,9,0,Matches
Kaoru Mitoma,352,jpJPN,"FW,MF",Brighton,27-354,1997,28.0,43,26,14,13,16,18,46,39.1,28,46,3,43,13,56,10,0,Matches
Kasey McAteer,337,ieIRL,"FW,MF",Leicester City,23-168,2001,6.8,14,11,7,4,3,9,21,42.9,12,13,1,12,3,17,11,0,Matches
Keane Lewis-Potter,302,engENG,"DF,FW",Brentford,24-076,2001,31.5,44,26,23,15,6,26,44,59.1,18,24,9,15,19,63,71,3,Matches
Kenny Tete,501,nlNED,DF,Fulham,29-212,1995,16.7,50,34,24,14,12,20,34,58.8,14,22,6,16,29,79,52,0,Matches
Kepa Arrizabalaga,35,esESP,GK,Bournemouth,30-218,1994,28.0,1,0,1,0,0,0,2,0.0,2,1,0,1,0,1,14,3,Matches
Kevin Danso,121,atAUT,DF,Tottenham,26-232,1998,6.4,6,5,3,3,0,5,8,62.5,3,7,7,0,3,9,44,1,Matches
Kevin De Bruyne,125,beBEL,"MF,FW",Manchester City,33-315,1991,17.1,17,9,7,5,5,5,23,21.7,18,8,0,8,7,24,10,1,Matches
Kevin Schade,455,deGER,FW,Brentford,23-163,2001,23.0,35,23,14,10,11,12,20,60.0,8,17,2,15,5,40,31,0,Matches
Kieran Tierney,505,sctSCO,"DF,FW",Arsenal,27-338,1997,2.0,5,4,3,1,1,3,5,60.0,2,0,0,0,2,7,5,0,Matches
Kieran Trippier,517,engENG,DF,Newcastle Utd,34-232,1990,14.2,37,20,18,13,6,21,35,60.0,14,11,3,8,12,49,49,0,Matches
Kiernan Dewsbury-Hall,130,engENG,"MF,FW",Chelsea,26-245,1998,2.9,8,5,1,1,6,4,6,66.7,2,2,0,2,1,9,8,1,Matches
Kim Jisoo,260,krKOR,DF,Brentford,20-136,2004,0.3,0,0,0,0,0,0,0,N/a,0,0,0,0,0,0,2,0,Matches
Kobbie Mainoo,320,engENG,MF,Manchester Utd,20-020,2005,16.7,42,25,16,13,13,22,36,61.1,14,16,2,14,19,61,12,1,Matches
Konstantinos Mavropanos,333,grGRE,DF,West Ham,27-149,1997,21.6,32,22,22,9,1,14,25,56.0,11,23,17,6,38,70,117,1,Matches
Kosta Nedeljković,372,rsSRB,DF,Aston Villa,19-144,2005,1.4,7,5,1,3,3,2,3,66.7,1,1,0,1,0,7,3,0,Matches
Kostas Tsimikas,519,grGRE,DF,Liverpool,28-362,1996,8.3,29,18,13,11,5,13,20,65.0,7,5,2,3,10,39,20,0,Matches
Kristoffer Ajer,10,noNOR,DF,Brentford,27-022,1998,15.6,25,17,14,10,1,14,26,53.8,12,17,4,13,12,37,49,0,Matches
Kyle Walker,534,engENG,DF,Manchester City,34-346,1990,10.8,17,10,7,7,3,14,26,53.8,12,13,4,9,3,20,13,1,Matches
Kyle Walker-Peters,535,engENG,DF,Southampton,28-026,1997,32.4,44,29,22,15,7,16,35,45.7,19,27,15,12,19,63,90,1,Matches
Lamare Bogarde,61,nlNED,"DF,MF",Aston Villa,21-124,2004,5.3,14,6,6,6,2,10,16,62.5,6,5,3,2,1,15,13,0,Matches
Leandro Trossard,518,beBEL,FW,Arsenal,30-156,1994,26.2,26,17,5,14,7,9,31,29.0,22,31,0,31,9,35,17,0,Matches
Leif Davis,123,engENG,DF,Ipswich Town,25-117,2000,28.5,45,26,32,9,4,29,46,63.0,17,24,8,16,25,70,72,3,Matches
Leny Yoro,563,frFRA,DF,Manchester Utd,19-177,2005,12.4,26,11,17,8,1,11,17,64.7,6,5,3,2,18,44,43,0,Matches
Leon Bailey,43,jmJAM,"FW,MF",Aston Villa,27-273,1997,12.6,6,4,1,3,2,2,10,20.0,8,6,0,6,3,9,12,0,Matches
Lesley Ugochukwu,523,frFRA,MF,Southampton,21-044,2004,16.9,49,24,15,30,4,18,33,54.5,15,26,9,17,14,63,21,1,Matches
Levi Colwill,107,engENG,DF,Chelsea,22-072,2003,32.0,42,30,22,17,3,16,25,64.0,9,35,24,11,32,74,104,4,Matches
Lewis Cook,108,engENG,"MF,DF",Bournemouth,28-095,1997,31.3,80,42,41,35,4,36,66,54.5,30,30,11,19,40,120,66,0,Matches
Lewis Dunk,152,engENG,DF,Brighton,33-169,1991,23.1,17,10,8,7,2,11,19,57.9,8,28,18,10,13,30,79,2,Matches
Lewis Hall,224,engENG,DF,Newcastle Utd,20-243,2004,24.3,58,41,28,22,8,40,74,54.1,34,33,18,15,18,76,75,3,Matches
Lewis Miley,347,engENG,MF,Newcastle Utd,19-008,2006,2.8,11,9,4,6,1,6,11,54.5,5,5,1,4,2,13,5,2,Matches
Lewis Orford,396,engENG,MF,West Ham,19-080,2006,0.5,0,0,0,0,0,0,0,N/a,0,1,0,1,1,1,0,0,Matches
Liam Delap,127,engENG,FW,Ipswich Town,22-090,2003,27.7,10,7,3,2,5,2,14,14.3,12,8,0,8,2,12,28,0,Matches
Lisandro Martínez,329,arARG,DF,Manchester Utd,27-111,1998,19.5,40,24,25,12,3,21,36,58.3,15,22,8,14,32,72,57,1,Matches
Lloyd Kelly,277,engENG,DF,Newcastle Utd,26-215,1998,3.4,5,4,4,1,0,1,1,100.0,0,6,4,2,1,6,17,0,Matches
Lucas Bergvall,55,seSWE,MF,Tottenham,19-096,2006,13.5,39,19,14,20,5,17,32,53.1,15,18,8,10,24,63,22,3,Matches
Lucas Digne,135,frFRA,DF,Aston Villa,31-293,1993,25.1,63,37,38,16,9,43,64,67.2,21,23,4,19,25,88,85,1,Matches
Lucas Paquetá,404,brBRA,"MF,FW",West Ham,27-255,1997,26.0,66,37,25,30,11,27,54,50.0,27,28,4,24,17,83,37,6,Matches
Luis Díaz,133,coCOL,FW,Liverpool,28-116,1997,24.7,33,21,10,17,6,13,34,38.2,21,18,0,18,7,40,7,1,Matches
Luis Guilherme,217,brBRA,"MF,FW",West Ham,19-089,2006,1.5,1,0,1,0,0,0,3,0.0,3,7,0,7,3,4,2,0,Matches
Luis Sinisterra,470,coCOL,"FW,MF",Bournemouth,25-326,1999,2.6,7,2,3,2,2,0,4,0.0,4,3,0,3,1,8,8,0,Matches
Luke Shaw,464,engENG,DF,Manchester Utd,29-301,1995,2.4,4,3,2,2,0,2,2,100.0,0,2,1,1,2,6,6,0,Matches
Luke Thomas,503,engENG,DF,Leicester City,23-333,2001,9.7,25,20,19,4,2,18,32,56.3,14,13,5,8,18,43,39,1,Matches
Luke Woolfenden,560,engENG,DF,Ipswich Town,26-200,1998,13.2,9,6,5,4,0,2,5,40.0,3,21,14,7,19,28,76,0,Matches
Mads Hermansen,235,dkDEN,GK,Leicester City,24-302,2000,26.5,1,1,1,0,0,1,1,100.0,0,1,0,1,0,1,13,4,Matches
Mads Roerslev,438,dkDEN,DF,Brentford,25-319,1999,12.2,18,8,14,3,1,11,28,39.3,17,12,5,7,4,22,35,0,Matches
Malo Gusto,221,frFRA,DF,Chelsea,21-355,2003,20.4,43,28,26,15,2,24,47,51.1,23,29,8,21,23,66,48,5,Matches
Manuel Akanji,11,chSUI,DF,Manchester City,29-294,1995,19.4,16,11,9,4,3,8,13,61.5,5,11,8,3,7,23,57,3,Matches
Manuel Ugarte Ribeiro,522,uyURU,MF,Manchester Utd,24-028,2001,19.0,74,46,32,34,8,28,66,42.4,38,31,4,27,26,100,16,1,Matches
Marc Cucurella,113,esESP,DF,Chelsea,26-291,1998,30.2,59,39,30,24,5,26,53,49.1,27,45,14,31,25,84,84,3,Matches
Marc Guiu,219,esESP,FW,Chelsea,19-125,2006,0.8,1,1,0,1,0,1,1,100.0,0,0,0,0,0,1,0,0,Matches
Marc Guéhi,216,engENG,DF,Crystal Palace,24-300,2000,33.0,56,31,32,22,2,30,46,65.2,16,54,22,32,25,81,156,2,Matches
Marco Asensio,36,esESP,"MF,FW",Aston Villa,29-108,1996,6.0,7,5,0,7,0,3,9,33.3,6,2,0,2,1,8,3,0,Matches
Marcos Senesi,462,arARG,DF,Bournemouth,27-364,1997,11.3,35,21,22,11,2,14,30,46.7,16,15,7,8,11,46,54,0,Matches
Marcus Harness,226,engENG,MF,Ipswich Town,29-074,1996,0.5,1,0,0,0,1,0,3,0.0,3,2,1,1,0,1,1,0,Matches
Marcus Rashford,422,engENG,"FW,MF",Manchester Utd,27-190,1997,10.9,7,4,2,2,3,3,9,33.3,6,8,0,8,4,11,7,0,Matches
Marcus Tavernier,497,engENG,"FW,MF",Bournemouth,26-048,1999,18.6,41,24,14,18,9,10,26,38.5,16,16,3,13,5,46,11,0,Matches
Mario Lemina,298,gaGAB,"MF,DF",Wolves,31-250,1993,15.2,51,31,27,19,5,20,29,69.0,9,12,7,5,27,78,50,3,Matches
Mark Flekken,182,nlNED,GK,Brentford,31-330,1993,33.4,4,4,4,0,0,3,9,33.3,6,2,0,2,0,4,26,4,Matches
Mark Travers,515,ieIRL,GK,Bournemouth,25-356,1999,5.0,0,0,0,0,0,0,0,N/a,0,0,0,0,0,0,5,0,Matches
Marshall Munetsi,363,zwZIM,"MF,FW",Wolves,28-321,1996,9.8,21,10,6,9,6,12,20,60.0,8,12,1,11,6,27,15,0,Matches
Martial Godo,200,engENG,FW,Fulham,22-056,2003,0.2,0,0,0,0,0,0,0,N/a,0,1,0,1,1,1,0,0,Matches
Martin Dúbravka,151,skSVK,GK,Newcastle Utd,36-114,1989,10.0,0,0,0,0,0,0,0,N/a,0,0,0,0,0,0,3,0,Matches
Martin Ødegaard,568,noNOR,MF,Arsenal,26-143,1998,23.7,19,11,9,7,3,4,24,16.7,20,5,0,5,4,23,5,1,Matches
Mason Holgate,240,engENG,"FW,DF",Everton,28-199,1996,0.1,0,0,0,0,0,0,0,N/a,0,0,0,0,0,0,0,0,Matches
Mason Mount,360,engENG,"MF,FW",Manchester Utd,26-119,1999,4.8,10,4,5,5,0,8,10,80.0,2,8,1,7,3,13,1,0,Matches
Massimo Luongo,312,auAUS,MF,Ipswich Town,32-226,1992,2.2,8,5,6,1,1,4,7,57.1,3,4,2,2,2,10,2,0,Matches
Mateo Kovačić,288,hrCRO,MF,Manchester City,31-003,1994,22.8,67,38,22,38,7,30,63,47.6,33,20,0,20,20,87,20,1,Matches
Mateus Fernandes,180,ptPOR,MF,Southampton,20-303,2004,29.3,86,46,43,28,15,33,64,51.6,31,40,6,34,21,107,31,6,Matches
Matheus Cunha,115,brBRA,"MF,FW",Wolves,25-347,1999,26.9,35,21,16,15,4,11,36,30.6,25,19,1,18,17,52,23,0,Matches
Matheus França,187,brBRA,"FW,MF",Crystal Palace,21-038,2004,0.3,1,0,0,1,0,0,0,N/a,0,0,0,0,0,1,0,0,Matches
Matheus Nunes,380,ptPOR,"DF,MF",Manchester City,26-255,1998,16.6,32,21,13,13,6,15,34,44.1,19,14,3,11,13,45,35,1,Matches
Mathias Jensen,257,dkDEN,MF,Brentford,29-128,1996,9.1,13,9,6,5,2,7,15,46.7,8,13,4,9,8,21,13,1,Matches
Mathis Amougou,22,frFRA,MF,Chelsea,19-111,2006,0.1,0,0,0,0,0,0,0,N/a,0,0,0,0,0,0,0,0,Matches
Mathys Tel,500,frFRA,FW,Tottenham,20-012,2005,7.2,8,3,0,4,4,2,9,22.2,7,6,0,6,0,8,2,2,Matches
Mats Wieffer,549,nlNED,"MF,DF",Brighton,25-174,1999,8.3,37,22,15,18,4,19,31,61.3,12,13,1,12,13,50,18,3,Matches
Matt Doherty,141,ieIRL,DF,Wolves,33-113,1992,21.8,37,20,25,12,0,16,24,66.7,8,26,15,11,21,58,91,3,Matches
Matt O'Riley,385,dkDEN,MF,Brighton,24-169,2000,9.4,15,9,4,8,3,4,12,33.3,8,7,3,4,13,28,8,1,Matches
Matt Targett,495,engENG,DF,Newcastle Utd,29-233,1995,0.2,0,0,0,0,0,0,1,0.0,1,0,0,0,1,1,1,0,Matches
Matthijs de Ligt,304,nlNED,DF,Manchester Utd,25-270,1999,23.6,30,22,17,12,1,23,32,71.9,9,29,21,8,33,63,96,0,Matches
Matty Cash,88,plPOL,DF,Aston Villa,27-275,1997,20.0,47,27,25,19,3,24,34,70.6,10,18,7,11,21,68,57,2,Matches
Matz Sels,459,beBEL,GK,Nott'ham Forest,33-072,1992,35.0,1,1,1,0,0,1,1,100.0,0,0,0,0,0,1,23,1,Matches
Max Aarons,1,engENG,DF,Bournemouth,25-125,2000,1.0,2,2,1,1,0,1,1,100.0,0,3,1,2,1,3,0,0,Matches
Max Kilman,281,engENG,DF,West Ham,27-351,1997,34.2,33,20,13,17,3,21,25,84.0,4,55,37,18,38,71,196,5,Matches
Maxence Lacroix,293,frFRA,DF,Crystal Palace,25-033,2000,31.6,67,40,51,15,1,32,47,68.1,15,43,18,25,52,119,190,2,Matches
Maxwel Cornet,109,ciCIV,FW,Southampton,28-224,1996,0.8,5,5,1,4,0,0,4,0.0,4,0,0,0,0,5,2,0,Matches
Michael Golding,201,engENG,MF,Leicester City,18-351,2006,0.0,0,0,0,0,0,0,0,N/a,0,0,0,0,0,0,0,0,Matches
Michael Kayode,274,itITA,DF,Brentford,20-303,2004,3.2,13,8,9,4,0,7,7,100.0,0,0,0,0,4,17,13,0,Matches
Michael Keane,275,engENG,DF,Everton,32-118,1993,9.5,10,7,7,2,1,7,13,53.8,6,11,7,4,10,20,55,2,Matches
Michail Antonio,27,jmJAM,FW,West Ham,35-042,1990,9.3,2,2,0,1,1,2,3,66.7,1,6,0,6,0,2,2,0,Matches
Micky van de Ven,529,nlNED,DF,Tottenham,24-020,2001,10.6,10,6,5,4,1,8,14,57.1,6,9,6,3,10,20,36,1,Matches
Miguel Almirón,17,pyPAR,FW,Newcastle Utd,31-088,1994,1.7,3,2,2,0,1,2,3,66.7,1,2,0,2,0,3,0,0,Matches
Mikel Merino,344,esESP,"MF,FW",Arsenal,28-321,1996,15.8,38,22,6,21,11,15,29,51.7,14,18,5,13,14,52,24,1,Matches
Mikey Moore,355,engENG,FW,Tottenham,17-271,2007,2.3,0,0,0,0,0,0,1,0.0,1,1,0,1,1,1,1,0,Matches
Mikkel Damsgaard,118,dkDEN,"MF,FW",Brentford,24-310,2000,29.5,78,43,27,26,25,28,72,38.9,44,36,2,34,26,104,30,2,Matches
Milos Kerkez,278,huHUN,DF,Bournemouth,21-183,2003,34.2,50,26,25,19,6,23,37,62.2,14,36,11,25,42,92,103,3,Matches
Mohamed Salah,444,egEGY,FW,Liverpool,32-328,1992,34.5,20,11,7,5,8,7,16,43.8,9,11,0,11,7,27,5,0,Matches
Mohammed Kudus,291,ghGHA,"FW,MF",West Ham,24-280,2000,26.9,35,21,7,17,11,10,27,37.0,17,24,1,23,4,39,8,2,Matches
Moisés Caicedo,79,ecECU,"MF,DF",Chelsea,23-188,2001,34.2,103,64,37,51,15,50,80,62.5,30,45,10,35,49,152,52,1,Matches
Morato,356,brBRA,DF,Nott'ham Forest,23-313,2001,9.0,21,13,18,2,1,13,20,65.0,7,12,4,8,10,31,71,2,Matches
Morgan Gibbs-White,197,engENG,MF,Nott'ham Forest,25-102,2000,28.2,40,19,14,20,6,15,30,50.0,15,16,4,12,20,60,28,1,Matches
Morgan Rogers,439,engENG,"FW,MF",Aston Villa,22-287,2002,31.7,36,18,13,13,10,19,39,48.7,20,25,7,18,5,41,19,2,Matches
Murillo,367,brBRA,DF,Nott'ham Forest,22-309,2002,33.4,53,36,38,12,3,27,46,58.7,19,67,44,23,32,85,236,3,Matches
Mykhailo Mudryk,362,uaUKR,FW,Chelsea,24-124,2001,1.7,2,2,2,0,0,0,0,N/a,0,3,1,2,0,2,1,0,Matches
Myles Lewis-Skelly,303,engENG,DF,Arsenal,18-225,2006,13.0,22,14,10,9,3,10,10,100.0,0,2,1,1,6,28,20,0,Matches
Nasser Djiga,140,bfBFA,"DF,FW",Wolves,22-175,2002,0.2,0,0,0,0,0,0,0,N/a,0,0,0,0,2,2,3,1,Matches
Nathan Aké,12,nlNED,DF,Manchester City,30-080,1995,7.5,9,7,7,2,0,4,6,66.7,2,7,2,5,3,12,22,1,Matches
Nathan Broadhead,69,wlsWAL,"MF,FW",Ipswich Town,27-034,1998,6.7,7,3,2,5,0,3,9,33.3,6,6,1,5,4,11,5,0,Matches
Nathan Butler-Oyedeji,78,engENG,FW,Arsenal,22-125,2003,0.1,0,0,0,0,0,0,0,N/a,0,0,0,0,0,0,0,0,Matches
Nathan Collins,105,ieIRL,DF,Brentford,24-009,2001,35.0,37,22,22,11,4,22,34,64.7,12,71,51,20,32,69,214,2,Matches
Nathan Patterson,406,sctSCO,DF,Everton,23-205,2001,3.9,11,6,7,4,0,7,14,50.0,7,2,0,2,2,13,7,0,Matches
Nathan Wood-Gordon,559,engENG,DF,Southampton,22-343,2002,6.9,10,7,6,3,1,5,8,62.5,3,8,5,3,4,14,26,2,Matches
Nathaniel Clyne,102,engENG,"DF,MF",Crystal Palace,34-034,1991,5.4,12,8,8,3,1,6,11,54.5,5,4,2,2,3,15,14,1,Matches
Neco Williams,550,wlsWAL,DF,Nott'ham Forest,24-026,2001,25.8,75,45,56,14,5,45,73,61.6,28,40,9,31,25,100,126,2,Matches
Neto,375,brBRA,GK,Bournemouth,35-294,1989,2.0,0,0,0,0,0,0,0,N/a,0,0,0,0,0,0,1,1,Matches
Nick Pope,416,engENG,GK,Newcastle Utd,33-020,1992,25.0,0,0,0,0,0,0,0,N/a,0,1,0,1,1,1,30,5,Matches
Niclas Füllkrug,190,deGER,FW,West Ham,32-089,1993,7.4,2,2,0,1,1,2,3,66.7,1,1,0,1,0,2,12,0,Matches
Nico O’Reilly,400,engENG,DF,Manchester City,20-049,2005,5.7,9,4,3,3,3,4,8,50.0,4,5,1,4,4,13,12,0,Matches
Nicolas Jackson,252,snSEN,FW,Chelsea,23-323,2001,24.3,22,13,6,7,9,5,10,50.0,5,14,2,12,3,25,15,0,Matches
Nicolás Domínguez,143,arARG,"MF,FW",Nott'ham Forest,26-315,1998,19.3,76,40,35,30,11,30,66,45.5,36,34,11,23,27,103,48,1,Matches
Nicolás González,207,esESP,MF,Manchester City,23-126,2002,7.2,15,6,5,6,4,6,11,54.5,5,9,0,9,5,20,17,0,Matches
Nikola Milenković,346,rsSRB,DF,Nott'ham Forest,27-209,1997,34.0,43,26,30,11,2,21,27,77.8,6,40,24,16,25,68,192,1,Matches
Noni Madueke,316,engENG,FW,Chelsea,23-060,2002,20.1,22,15,7,12,3,13,34,38.2,21,17,0,17,8,30,11,0,Matches
Noussair Mazraoui,334,maMAR,DF,Manchester Utd,27-176,1997,29.3,102,60,53,36,13,51,85,60.0,34,33,8,25,34,136,88,1,Matches
Nélson Semedo,460,ptPOR,DF,Wolves,31-174,1993,29.6,58,34,31,20,7,30,53,56.6,23,28,10,18,23,81,100,3,Matches
Odsonne Édouard,156,frFRA,"MF,FW",Crystal Palace,27-113,1998,1.3,1,0,0,1,0,0,2,0.0,2,1,0,1,0,1,1,0,Matches
Ola Aina,8,ngNGA,DF,Nott'ham Forest,28-213,1996,30.4,54,41,39,14,1,35,63,55.6,28,32,12,20,31,85,103,3,Matches
Oleksandr Zinchenko,566,uaUKR,"DF,MF",Arsenal,28-145,1996,5.1,4,1,1,2,1,2,7,28.6,5,5,0,5,4,8,6,0,Matches
Oliver Scarles,453,engENG,DF,West Ham,19-148,2005,6.6,17,11,13,3,1,13,21,61.9,8,14,2,12,10,27,24,0,Matches
Oliver Skipp,471,engENG,MF,Leicester City,24-235,2000,11.1,20,4,5,12,3,9,15,60.0,6,17,4,13,10,30,10,1,Matches
Ollie Watkins,542,engENG,FW,Aston Villa,29-130,1995,25.9,9,6,0,5,4,3,11,27.3,8,11,3,8,8,17,15,2,Matches
Omar Marmoush,326,egEGY,"FW,MF",Manchester City,26-091,1999,11.1,11,6,2,7,2,7,15,46.7,8,15,1,14,5,16,3,0,Matches
Omari Hutchinson,244,engENG,"MF,FW",Ipswich Town,21-191,2003,25.7,31,12,14,10,7,13,45,28.9,32,25,1,24,10,41,13,1,Matches
Orel Mangala,323,beBEL,MF,Everton,27-052,1998,14.0,16,8,3,11,2,5,8,62.5,3,8,3,5,21,37,24,1,Matches
Oscar Bobb,60,noNOR,FW,Manchester City,21-301,2003,0.2,0,0,0,0,0,0,0,N/a,0,0,0,0,0,0,0,0,Matches
Pablo Sarabia,449,esESP,"MF,FW",Wolves,32-363,1992,8.0,15,8,4,8,3,9,14,64.3,5,10,0,10,4,19,7,1,Matches
Pape Matar Sarr,330,snSEN,MF,Tottenham,22-237,2002,19.2,44,32,17,22,5,11,23,47.8,12,23,9,14,26,70,20,1,Matches
Patrick Dorgu,144,dkDEN,DF,Manchester Utd,20-195,2004,7.0,23,17,12,9,2,12,17,70.6,5,9,0,9,4,27,19,2,Matches
Patson Daka,116,zmZAM,"FW,MF",Leicester City,26-212,1998,7.3,17,9,4,9,4,7,17,41.2,10,7,1,6,1,18,10,0,Matches
Pau Torres,511,esESP,DF,Aston Villa,28-113,1997,20.2,20,14,11,7,2,9,15,60.0,6,14,10,4,9,29,65,2,Matches
Paul Onuachu,394,ngNGA,FW,Southampton,30-346,1994,11.4,7,2,1,5,1,3,7,42.9,4,7,2,5,1,8,16,1,Matches
Pedro Lima,305,brBRA,DF,Wolves,18-312,2006,0.8,1,0,0,0,1,1,3,33.3,2,0,0,0,2,3,5,0,Matches
Pedro Neto,376,ptPOR,FW,Chelsea,25-061,2000,22.4,22,9,9,9,4,8,19,42.1,11,13,2,11,9,31,6,0,Matches
Pedro Porro,417,esESP,DF,Tottenham,25-238,1999,27.4,63,46,31,22,10,42,73,57.5,31,44,17,27,34,97,80,1,Matches
Pervis Estupiñán,168,ecECU,DF,Brighton,27-108,1998,24.7,58,39,30,21,7,31,46,67.4,15,16,2,14,34,92,55,2,Matches
Phil Foden,183,engENG,"MF,FW",Manchester City,24-346,2000,18.8,12,5,5,4,3,7,17,41.2,10,12,1,11,9,21,7,1,Matches
Philip Billing,58,dkDEN,MF,Bournemouth,28-332,1996,2.0,14,5,7,6,1,3,4,75.0,1,3,0,3,5,19,2,0,Matches
Radu Drăgușin,150,roROU,DF,Tottenham,23-095,2002,13.9,10,6,8,2,0,6,12,50.0,6,22,16,6,15,25,49,4,Matches
Raheem Sterling,485,engENG,"FW,MF",Arsenal,30-152,1994,4.9,8,4,1,2,5,4,8,50.0,4,3,0,3,1,9,3,0,Matches
Ramón Sosa,478,pyPAR,"FW,MF",Nott'ham Forest,25-251,1999,3.3,5,3,3,0,2,1,5,20.0,4,9,0,9,4,9,5,0,Matches
Rasmus Højlund,245,dkDEN,FW,Manchester Utd,22-094,2003,19.4,3,1,0,2,1,0,4,0.0,4,5,0,5,1,4,6,0,Matches
Rayan Aït-Nouri,9,dzALG,DF,Wolves,23-337,2001,31.8,82,52,50,25,7,41,67,61.2,26,40,6,34,24,106,67,1,Matches
Raúl Jiménez,259,mxMEX,FW,Fulham,34-004,1991,24.7,33,23,8,17,8,7,20,35.0,13,19,5,14,10,43,19,3,Matches
Reece James,253,engENG,"DF,MF",Chelsea,25-152,1999,9.3,9,9,5,3,1,3,9,33.3,6,12,4,8,12,21,18,4,Matches
Reiss Nelson,373,engENG,FW,Arsenal,25-150,1999,0.0,1,0,0,1,0,0,1,0.0,1,0,0,0,0,1,1,0,Matches
Remy Rees-Dottin,426,engENG,FW,Bournemouth,19-064,2006,0.0,0,0,0,0,0,0,0,N/a,0,0,0,0,0,0,0,0,Matches
Renato Veiga,527,ptPOR,"DF,MF",Chelsea,21-284,2003,2.0,9,6,6,3,0,4,12,33.3,8,3,1,2,1,10,2,0,Matches
Ricardo Pereira,408,ptPOR,DF,Leicester City,31-215,1993,3.8,11,6,4,4,3,6,12,50.0,6,6,2,4,2,13,10,0,Matches
Riccardo Calafiori,82,itITA,DF,Arsenal,22-355,2002,10.3,26,18,15,9,2,18,29,62.1,11,12,6,6,9,35,25,0,Matches
Richarlison,432,brBRA,FW,Tottenham,27-364,1997,5.3,4,3,0,3,1,0,2,0.0,2,1,1,0,0,4,8,0,Matches
Rico Henry,234,engENG,DF,Brentford,27-305,1997,0.9,0,0,0,0,0,0,4,0.0,4,3,1,2,1,1,2,0,Matches
Rico Lewis,301,engENG,"DF,MF",Manchester City,20-169,2004,20.2,29,19,13,12,4,13,21,61.9,8,28,7,21,13,42,43,1,Matches
Robert Sánchez,446,esESP,GK,Chelsea,27-172,1997,29.0,0,0,0,0,0,0,1,0.0,1,0,0,0,2,2,20,9,Matches
Robin Olsen,391,seSWE,GK,Aston Villa,35-121,1990,2.0,1,0,1,0,0,1,1,100.0,0,0,0,0,0,1,2,1,Matches
Rodri,436,esESP,MF,Manchester City,28-321,1996,0.7,2,1,1,1,0,0,0,N/a,0,1,0,1,1,3,0,0,Matches
Rodrigo Bentancur,52,uyURU,MF,Tottenham,27-318,1997,16.9,38,20,17,17,4,19,39,48.7,20,24,8,16,36,74,33,1,Matches
Rodrigo Gomes,203,ptPOR,"DF,FW",Wolves,21-306,2003,7.5,21,13,12,9,0,10,19,52.6,9,8,1,7,5,26,20,1,Matches
Rodrigo Muniz,364,brBRA,FW,Fulham,24-005,2001,10.7,10,5,3,5,2,4,4,100.0,0,9,2,7,5,15,14,0,Matches
Romain Esse,167,engENG,MF,Crystal Palace,19-361,2005,0.4,2,2,2,0,0,2,2,100.0,0,1,0,1,1,3,0,0,Matches
Roman Dixon,139,engENG,DF,Everton,20-134,2004,1.0,5,5,3,2,0,4,4,100.0,0,1,0,1,1,6,3,0,Matches
Roméo Lavia,297,beBEL,MF,Chelsea,21-123,2004,7.6,21,13,5,12,4,9,19,47.4,10,6,0,6,14,35,8,0,Matches
Ronnie Edwards,159,engENG,DF,Southampton,22-042,2003,0.1,0,0,0,0,0,0,0,N/a,0,1,1,0,0,0,0,0,Matches
Ross Barkley,45,engENG,MF,Aston Villa,31-155,1993,6.3,14,3,4,10,0,9,14,64.3,5,9,3,6,10,24,5,0,Matches
Ross Stewart,486,sctSCO,FW,Southampton,28-302,1996,3.2,3,2,1,0,2,2,6,33.3,4,3,0,3,0,3,6,0,Matches
Ryan Christie,99,sctSCO,MF,Bournemouth,30-076,1995,23.5,54,33,19,27,8,27,64,42.2,37,44,11,33,30,84,51,3,Matches
Ryan Fraser,188,sctSCO,"FW,DF",Southampton,31-074,1994,3.4,6,2,2,4,0,4,6,66.7,2,1,1,0,1,7,9,0,Matches
Ryan Gravenberch,209,nlNED,MF,Liverpool,22-358,2002,32.5,65,34,25,29,11,30,51,58.8,21,34,10,24,57,122,56,1,Matches
Ryan Manning,324,ieIRL,"DF,MF",Southampton,28-329,1996,16.2,28,17,16,10,2,14,26,53.8,12,20,11,9,17,45,45,0,Matches
Ryan Sessegnon,463,engENG,"FW,DF",Fulham,24-356,2000,5.2,21,11,8,8,5,6,15,40.0,9,11,0,11,3,24,11,0,Matches
Ryan Trevitt,516,engENG,MF,Brentford,22-058,2003,0.0,1,1,1,0,0,0,0,N/a,0,0,0,0,0,1,0,0,Matches
Ryan Yates,562,engENG,MF,Nott'ham Forest,27-169,1997,20.8,41,21,23,14,4,17,37,45.9,20,35,9,26,26,67,61,1,Matches
Rúben Dias,132,ptPOR,DF,Manchester City,27-360,1997,22.2,16,10,6,9,1,7,11,63.6,4,17,14,3,18,34,59,3,Matches
Sam Johnstone,265,engENG,GK,Wolves,32-045,1993,7.0,0,0,0,0,0,0,1,0.0,1,0,0,0,0,0,7,0,Matches
Sam Morsy,358,egEGY,MF,Ipswich Town,33-241,1991,27.6,62,36,35,23,4,26,57,45.6,31,32,13,19,28,90,43,4,Matches
Sammie Szmodics,493,ieIRL,"FW,MF",Ipswich Town,29-227,1995,10.9,15,9,4,9,2,6,23,26.1,17,10,2,8,6,21,14,0,Matches
Samuel Amo-Ameyaw,21,engENG,"FW,DF",Southampton,18-295,2006,0.3,1,0,0,1,0,1,1,100.0,0,0,0,0,0,1,0,0,Matches
Samuel Edozie,158,engENG,"DF,FW",Southampton,22-101,2003,0.7,3,1,0,1,2,2,2,100.0,0,0,0,0,0,3,0,0,Matches
Sander Berge,54,noNOR,MF,Fulham,27-084,1998,23.2,48,28,22,22,4,25,37,67.6,12,26,8,18,20,68,34,1,Matches
Sandro Tonali,510,itITA,MF,Newcastle Utd,25-001,2000,26.2,47,30,20,22,5,22,44,50.0,22,32,10,22,33,80,32,2,Matches
Santiago Bueno,73,uyURU,DF,Wolves,26-181,1998,18.7,40,21,21,18,1,17,22,77.3,5,35,20,15,15,55,70,0,Matches
Saša Lukić,310,rsSRB,MF,Fulham,28-269,1996,24.1,66,37,21,39,6,21,53,39.6,32,19,7,12,26,92,32,0,Matches
Scott McTominay,341,sctSCO,MF,Manchester Utd,28-152,1996,0.2,0,0,0,0,0,0,1,0.0,1,0,0,0,0,0,1,0,Matches
Sean Longstaff,309,engENG,MF,Newcastle Utd,27-191,1997,8.9,27,16,10,9,8,18,27,66.7,9,17,5,12,7,34,8,0,Matches
Sepp van den Berg,128,nlNED,DF,Brentford,23-140,2001,25.7,37,22,23,10,4,18,27,66.7,9,50,36,14,20,57,118,2,Matches
Sergio Reguilón,427,esESP,DF,Tottenham,28-144,1996,1.4,4,3,1,3,0,2,3,66.7,1,4,0,4,2,6,3,0,Matches
Shumaira Mheuka,345,engENG,MF,Chelsea,17-201,2007,0.0,0,0,0,0,0,0,0,N/a,0,0,0,0,0,0,0,0,Matches
Simon Adingra,5,ciCIV,"FW,MF",Brighton,23-128,2002,10.6,23,14,10,8,5,10,22,45.5,12,12,0,12,8,31,6,1,Matches
Solly March,325,engENG,"FW,MF",Brighton,30-293,1994,1.9,6,3,2,2,2,5,8,62.5,3,3,0,3,2,8,2,1,Matches
Son Heung-min,236,krKOR,FW,Tottenham,32-305,1992,22.3,17,9,3,8,6,5,23,21.7,18,10,0,10,5,22,16,1,Matches
Stefan Ortega,397,deGER,GK,Manchester City,32-184,1992,12.2,0,0,0,0,0,0,1,0.0,1,0,0,0,0,0,11,1,Matches
Stephy Mavididi,332,engENG,FW,Leicester City,26-343,1998,17.9,34,19,16,10,8,14,42,33.3,28,26,2,24,11,45,15,0,Matches
Sven Botman,63,nlNED,DF,Newcastle Utd,25-117,2000,2.6,6,4,3,3,0,2,3,66.7,1,2,1,1,4,10,16,0,Matches
Sávio,452,brBRA,"FW,MF",Manchester City,21-029,2004,19.3,22,16,5,10,7,9,18,50.0,9,13,2,11,6,28,9,1,Matches
Séamus Coleman,104,ieIRL,DF,Everton,36-210,1988,2.2,2,1,1,1,0,2,3,66.7,1,5,3,2,1,3,7,0,Matches
Taiwo Awoniyi,38,ngNGA,FW,Nott'ham Forest,27-270,1997,4.5,6,3,0,3,3,4,5,80.0,1,1,0,1,0,6,7,0,Matches
Takehiro Tomiyasu,509,jpJPN,DF,Arsenal,26-185,1998,0.1,0,0,0,0,0,0,0,N/a,0,0,0,0,0,0,1,0,Matches
Tariq Lamptey,295,ghGHA,DF,Brighton,24-221,2000,8.9,14,10,8,6,0,7,22,31.8,15,14,7,7,6,20,22,1,Matches
Taylor Harwood-Bellis,228,engENG,DF,Southampton,23-099,2002,29.5,27,19,13,11,3,19,34,55.9,15,60,38,22,30,57,133,6,Matches
Thiago,502,brBRA,FW,Brentford,23-317,2001,1.6,3,2,1,0,2,0,1,0.0,1,2,0,2,2,5,2,1,Matches
Thomas Partey,405,ghGHA,"MF,DF",Arsenal,31-330,1993,28.1,80,49,23,37,20,44,72,61.1,28,25,7,18,33,113,46,4,Matches
Tim Iroegbunam,248,engENG,MF,Everton,21-313,2003,6.3,28,13,13,10,5,14,23,60.9,9,17,4,13,15,43,11,1,Matches
Timo Werner,546,deGER,"FW,MF",Tottenham,29-064,1996,5.7,6,4,3,3,0,3,13,23.1,10,10,1,9,1,7,7,0,Matches
Timothy Castagne,90,beBEL,DF,Fulham,29-155,1995,18.3,46,29,28,15,3,26,45,57.8,19,15,6,9,22,68,83,0,Matches
Toby Collyer,106,engENG,MF,Manchester Utd,21-126,2004,2.0,12,9,6,6,0,5,6,83.3,1,2,1,1,2,14,3,0,Matches
Tom Cairney,80,sctSCO,MF,Fulham,34-109,1991,5.5,11,5,4,2,5,4,7,57.1,3,5,1,4,4,15,1,1,Matches
Tommy Doyle,149,engENG,MF,Wolves,23-204,2001,5.4,11,6,6,3,2,6,15,40.0,9,11,5,6,5,16,11,1,Matches
Tomáš Souček,479,czCZE,MF,West Ham,30-071,1995,25.9,42,19,19,20,3,22,39,56.4,17,35,17,18,18,60,74,1,Matches
Tosin Adarabioyo,4,engENG,DF,Chelsea,27-227,1997,13.7,14,10,10,4,0,8,12,66.7,4,9,7,2,10,24,62,0,Matches
Toti Gomes,204,ptPOR,DF,Wolves,26-113,1999,26.0,53,38,37,14,2,30,37,81.1,7,28,17,11,23,76,134,5,Matches
Trent Alexander-Arnold,15,engENG,DF,Liverpool,26-214,1998,25.5,70,49,43,18,9,48,103,46.6,55,26,9,17,30,100,54,4,Matches
Trevoh Chalobah,91,engENG,DF,Crystal Palace,25-308,1999,11.8,20,16,7,12,1,12,23,52.2,11,19,9,10,19,39,57,3,Matches
Tyler Adams,3,usUSA,MF,Bournemouth,26-084,1999,19.0,75,46,24,44,7,35,66,53.0,31,33,10,23,32,107,38,0,Matches
Tyler Dibling,134,engENG,"FW,MF",Southampton,19-058,2006,19.4,34,20,13,18,3,16,26,61.5,10,19,5,14,8,42,15,1,Matches
Tyler Fredricson,189,engENG,DF,Manchester Utd,20-075,2005,1.8,5,3,3,2,0,1,2,50.0,1,2,0,2,1,6,11,0,Matches
Tyrell Malacia,321,nlNED,DF,Manchester Utd,25-265,1999,1.1,2,1,2,0,0,1,2,50.0,1,0,0,0,1,3,1,1,Matches
Tyrick Mitchell,351,engENG,DF,Crystal Palace,25-250,1999,32.7,87,54,54,26,7,22,42,52.4,20,62,12,50,14,101,99,2,Matches
Tyrique George,196,engENG,FW,Chelsea,19-094,2006,1.1,2,0,2,0,0,2,3,66.7,1,0,0,0,1,3,1,0,Matches
Tyrone Mings,349,engENG,DF,Aston Villa,32-057,1993,11.7,6,5,5,1,0,2,2,100.0,0,13,11,2,7,13,58,1,Matches
Valentino Livramento,308,engENG,DF,Newcastle Utd,22-178,2002,28.6,52,34,33,15,4,30,56,53.6,26,34,10,24,21,73,99,1,Matches
Victor Bernth Kristiansen,56,dkDEN,DF,Leicester City,22-144,2002,26.4,85,50,54,26,5,47,87,54.0,40,37,14,23,40,125,72,3,Matches
Victor Lindelöf,306,seSWE,DF,Manchester Utd,30-296,1994,5.4,5,1,5,0,0,2,3,66.7,1,4,2,2,7,12,33,1,Matches
Virgil van Dijk,525,nlNED,DF,Liverpool,33-305,1991,35.0,35,17,17,16,2,11,20,55.0,9,25,14,11,54,89,179,4,Matches
Vitaliy Mykolenko,369,uaUKR,DF,Everton,25-345,1999,31.2,55,33,33,14,8,26,51,51.0,25,24,9,15,37,92,135,1,Matches
Vitaly Janelt,254,deGER,MF,Brentford,26-364,1998,25.0,38,22,14,13,11,21,36,58.3,15,33,9,24,27,65,53,1,Matches
Vitezslav Jaros,255,czCZE,GK,Liverpool,23-290,2001,0.1,0,0,0,0,0,0,0,N/a,0,0,0,0,0,0,0,0,Matches
Vitor Reis,428,brBRA,DF,Manchester City,19-117,2006,0.0,0,0,0,0,0,0,0,N/a,0,0,0,0,0,0,1,0,Matches
Vladimír Coufal,110,czCZE,DF,West Ham,32-260,1992,9.7,17,11,10,5,2,7,18,38.9,11,13,11,2,8,25,37,1,Matches
Wataru Endo,165,jpJPN,MF,Liverpool,32-089,1993,2.6,11,8,6,5,0,6,10,60.0,4,7,1,6,3,14,7,0,Matches
Welington,545,brBRA,"DF,MF",Southampton,24-079,2001,2.4,13,5,9,3,1,7,12,58.3,5,3,1,2,3,16,12,0,Matches
Wes Burns,77,wlsWAL,"FW,DF",Ipswich Town,30-167,1994,10.3,13,11,1,9,3,4,10,40.0,6,7,2,5,10,23,13,2,Matches
Wesley Fofana,184,frFRA,DF,Chelsea,24-143,2000,13.0,13,12,6,7,0,6,14,42.9,8,14,9,5,14,27,55,2,Matches
Wilfred Ndidi,371,ngNGA,MF,Leicester City,28-144,1996,23.9,81,50,45,29,7,27,54,50.0,27,47,19,28,26,107,72,0,Matches
Will Alves,19,engENG,FW,Leicester City,20-095,2005,0.0,0,0,0,0,0,0,0,N/a,0,0,0,0,0,0,0,0,Matches
Will Hughes,242,engENG,MF,Crystal Palace,30-022,1995,21.1,61,33,17,31,13,27,59,45.8,32,30,14,16,19,80,24,3,Matches
Will Lankshear,296,engENG,"FW,MF",Tottenham,20-019,2005,0.1,0,0,0,0,0,0,0,N/a,0,0,0,0,0,0,0,0,Matches
William Osula,398,dkDEN,FW,Newcastle Utd,21-278,2003,1.2,1,0,0,0,1,0,2,0.0,2,0,0,0,4,5,2,0,Matches
William Saliba,445,frFRA,DF,Arsenal,24-046,2001,32.3,60,36,35,23,2,21,27,77.8,6,24,15,9,21,81,111,6,Matches
William Smallbone,472,ieIRL,MF,Southampton,25-077,2000,7.2,18,11,8,8,2,7,21,33.3,14,8,0,8,2,20,12,2,Matches
Willian,551,brBRA,"FW,MF",Fulham,36-273,1988,2.7,3,1,0,2,1,1,5,20.0,4,0,0,0,1,4,1,0,Matches
Willy Boly,62,ciCIV,DF,Nott'ham Forest,34-095,1991,1.7,6,1,5,1,0,4,4,100.0,0,4,2,2,3,9,12,0,Matches
Wilson Odobert,388,frFRA,FW,Tottenham,20-162,2004,7.0,9,3,4,3,2,6,11,54.5,5,4,0,4,3,12,3,1,Matches
Wout Faes,174,beBEL,DF,Leicester City,27-036,1998,28.3,39,23,25,12,2,23,43,53.5,20,45,33,12,26,65,160,4,Matches
Woyo Coulibaly,111,frFRA,DF,Leicester City,25-354,1999,1.2,6,4,4,2,0,2,2,100.0,0,3,1,2,5,11,1,0,Matches
Yankuba Minteh,350,gmGAM,"FW,MF",Brighton,20-291,2004,17.6,45,32,24,13,8,17,45,37.8,28,20,0,20,11,56,31,0,Matches
Yasin Ayari,39,seSWE,MF,Brighton,21-215,2003,19.5,54,29,15,29,10,21,51,41.2,30,23,6,17,20,74,24,0,Matches
Yehor Yarmoliuk,561,uaUKR,MF,Brentford,21-069,2004,13.3,39,24,14,19,6,23,46,50.0,23,24,7,17,10,49,31,0,Matches
Yerson Mosquera,359,coCOL,DF,Wolves,24-007,2001,4.9,11,7,9,2,0,9,14,64.3,5,13,10,3,10,21,14,0,Matches
Yoane Wissa,557,cdCOD,FW,Brentford,28-248,1996,29.4,22,12,6,8,8,11,27,40.7,16,29,8,21,8,30,20,3,Matches
Youri Tielemans,504,beBEL,MF,Aston Villa,28-002,1997,33.3,83,57,31,44,8,40,73,54.8,33,37,16,21,22,105,47,4,Matches
Youssef Chermiti,94,ptPOR,"FW,MF",Everton,20-350,2004,0.5,0,0,0,0,0,0,1,0.0,1,0,0,0,0,0,0,0,Matches
Yukinari Sugawara,490,jpJPN,"DF,MF",Southampton,24-315,2000,16.3,29,16,14,14,1,18,30,60.0,12,17,7,10,10,39,46,3,Matches
Yunus Emre Konak,162,trTUR,"FW,MF",Brentford,19-119,2006,0.5,4,4,0,4,0,1,2,50.0,1,2,0,2,0,4,0,0,Matches
Yves Bissouma,59,mlMLI,MF,Tottenham,28-252,1996,14.4,47,29,19,25,3,18,33,54.5,15,9,6,3,16,63,35,4,Matches
Zain Silcott-Duberry,465,msMSR,FW,Bournemouth,19-304,2005,0.0,1,1,0,0,1,1,1,100.0,0,0,0,0,0,1,0,0,Matches
Álex Moreno,357,esESP,"DF,MF",Nott'ham Forest,31-335,1993,10.6,25,18,20,5,0,15,39,38.5,24,11,5,6,15,40,43,0,Matches
İlkay Gündoğan,220,deGER,MF,Manchester City,34-197,1990,22.8,24,13,4,15,5,10,23,43.5,13,14,0,14,13,37,22,0,Matches
Łukasz Fabiański,173,plPOL,GK,West Ham,40-021,1985,11.9,0,0,0,0,0,0,1,0.0,1,0,0,0,0,0,5,1,Matches
